++++++++++++++++++++++++
+  +  +       +       ++
+       ++ +          ++
+++++ ++++++ +++++ +++++
+       +++++++       ++
+ +++++++   S +  +    ++
+              +++    ++
++++++++++++++++++ +++++